#######################################################
#                                                     #
#                                                     #
##       ###        #####                          ####
#                                                     #
#                                                     #
###  ###         #####          ####           #   ####
#                                                     #
#                                                     #
###              ###            ###            #   ####
#                                                     #
#                                                     #
########                           #####       #   ####
#                                                     #
#                                                     #
#######################################################